XX  S    X  XXX   XX
XSS S S  X S X S SSX
 S   S  SX S S   SSS
XXXXX S  X S SS   SS
 S  X X  X   S    SS
   XXXXXXXXXXXXXX  S
  S   X     S   X  S
   S  XS  S    XXS
      S   XXXXXXX   
    S  S  X S       
 S        X  S  S SS
      S   X  S   S S
          X    S    
          XS        
   WXXXXXXX      S  
              S  S  
X                 SX
X S      S S    S  X
X    S  SS  S  S S X
XX               SXX
